C 119, 181, 254 
F 206, 206, 206 
NO ./textures/42/mac_back.xpm
EA ./textures/42/mac.xpm         
SO ./textures/42/42.xpm     
WE ./textures/42/tac.xpm

1111111111111111111111111111111111111111111111111111111111111111
1000000000000000000000000000000000000000000000000000000000000011
1000000000010000010110100111110001100111111111111111110000000011
10000000011 110001001010000001000110000000000000001  10000000011
10000000011 1101110110111111110001100000000000000011110000000011
100000000001000000001000000000000000000000000000000000N000000001
1111111111111111111111111111111111111111111111111111111111111111
