C 243, 243, 243 
F 210, 235, 238 
NO ./textures/bocal/mel.xpm
EA ./textures/bocal/yoshi.xpm         
SO ./textures/bocal/palmi.xpm     
WE ./textures/bocal/tac.xpm

             111    11111111111111111
           111      11111 10000000001
         111        111   10000N00001
       111          1     11111111111
     111                11111111111
   111                 1111111111
 111                  111111111
111                  11111111
10111111111111111   1111111      1
10000000000000001   1000001     11   
11111111111111101   1000001   1111
              101   1000001 111111
              101   11111111111111
              101
              111
