C 119, 181, 254 
F 210, 235, 238 
NO ./textures/clusters/mac.xpm
EA ./textures/clusters/tac.xpm         
SO ./textures/clusters/mac_back.xpm     
WE ./textures/clusters/42.xpm

                                                                                       1111111111111111111111111
                                                                                       1000000000000000000000001
                                                                                       1011100001111111111111001
                                                                                       1000000000000000000000001
                                                                                       1011100001111111111111001
                                                                                       1000000000000000000000001
                                                                                       1011100001111111111111001
                                                                                       1000000000000000000000001
                                                                                       1011100001111111111111001
                                                                                       1000000000000000000000001
                                                                                       1011100001111111111111001
                                                                                       1000000000000000000000001
                                                                                       1011100001111111111111001
                                                                                       1000000000000000000000001
                                                                                       1111110011111111111111111
                                                                                       1000000000000000000000001
                                                                                       1011100001111111111111001
                                                                                       1000000000000000000000001
                                                                                       1011100001111111111111101
                                                                                       1000000000000000000000001
                                                                                       1011100001111111111111101
                                                                                       1000000000000000000000001
                                                                                       1011100001111111111111101
                                      111111111111                                     1000000000000000000000001
1111111111111111111111111111111111111110000000000111111111111111111111111111111111111111111100001111111111111101
1000000000000100000000000000000100000010000000000100000000000000000000010000000010000000000100000000000000000001
1000000000000100000000000000000100000010000000000100000000000000000000010000000010000000000000001111111111111101
1000000000000111111100111111111100000011111001111100000000000000000000010000000010000000000000000000000000000001
1000000000000000000000000000000000000000000000000000000000000N00000000011111111110011100111100001111111111111101
1000000000000111111111111111111111111111111001111100000000000000000000000000000000010000000100000000000000000001
10000000000001                        10000000000100000000000000000000000000000000010000000100001111111111111101
10000000000001                        10000000000100000000000000000000010000000000010000000100000000000000000001
11111111111111                        10000000000111111111111111111111111111111111111111111111111111111111111111
                                      111111111111
