C 243, 243, 243 
F 210, 235, 238 
NO ./textures/clusters/mac.xpm
EA ./textures/clusters/tac.xpm         
SO ./textures/clusters/mac_back.xpm     
WE ./textures/clusters/42.xpm

                                                                                       1111111111111111111111111
                                                                                       1000000000000000000000001
                                                                                       1011100001111111111111001
                                                                                       1000000000000000000000001
                                                                                       1011100001111111111111001
                                                                                       1000000000000000000000001
                                                                                       1011100001111111111111001
                                                                                       1000000000000000000000001
                                                                                       1011100001111111111111001
                                                                                       1000000000000000000000001
                                                                                       1111001111111111111111111
                                                                                       1000000000000000000000001
                                                                                       1011100001111111111111001
                                                                                       1000000000000000000000001
                                                                                       1011100001111111111111101
                                                                                       1000000000000000000000001
                                                                                       1011100001111111111111101
                                                                                       1000000000000000000000001
                                                                                       1011100001111111111111101
                                                                                       1000000000000000000000001
11111111111111                 111111111111111111111111111111111111111111111111111111111000000001111111111111101
10000000000001                 100000010000000000100000000000000000000100000000000000001000000000000000000000001
10000000000001                 100000010000000000100000000000000000000100000000000000000000000001111111111111101
1000000000000111111111111111111100000011111001111100000000000000000000100000000000000000000000000000000000000001
1000000000000000000000000000000000000000000000000000000000000N00000000100000000000000001000000001111111111111101
1000000000000111111111111111111111111111111001111100000000000000000000100111110011111111000000000000000000000001
10000000000001                        10000000000100000000000000000000000001000000000001000000001111111111111101
10000000000001                        10000000000100000000000000000000000001000000000001000000000000000000000001
1111111111111111111111111111111111111111111111111111111111111111111111111111111111111111111111111111111111111111
