





11111
11111
11111
11111
11111
100001
10000011111111111111111111
100000000000000001110000001
11000000000000001   1000001
100000000000000011111000001
111111111111111111111111111
	1
	1
1111111111111
10000000000001
10000000000001
11111111111111 
 