C 119, 181, 254 
F 206, 206, 206 
EA ./textures/red.xpm
NO ./textures/eagle.xpm         
SO ./textures/greystone.xpm     
WE ./textures/purplestone.xpm

1111111111111111111111111111111111111111111111111111111111111111
1000000000000000000000000000S0000000000000000000000000000000001
1000000000000000000000000000000000000000000000000000000000000001
1000000000000000000000010001000100000000000000000000000000000001
1000000000000000011111111010001000000000000000000000000000000001
1000000000000000000000000000001000000000000000000000000000000001
1111111111111111111111111111111111111111111111111111111111111111
