C 255, 20, 30 
F 250, 46, 6 
EA ./textures/red.xpm
NO ./textures/eagle.xpm         
SO ./textures/greystone.xpm     
WE ./textures/purplestone.xpm

1111111111111111111111111111111111111111111111111111111111111111
1000000000000000000000000000000000000000000000000000000000000001
1000000000000000000000000000000000000000000000000000000000000001
100000000000000000000000000000W000000000000000000000000000000001
1000000000000000011111111000000000000000000000000000000000000001
1000000000000000000000000000000000000000000000000000000000000001
1111111111111111111111111111111111111111111111111111111111111111
