C 119, 181, 254 
F 206, 206, 206 
EA ./textures/white_wall.xpm
NO ./textures/dark_wall.xpm         
SO ./textures/grey_wall.xpm     
WE ./textures/purple_wall.xpm

1111111111111111111111111111111111111111111111111111111111111111
1000000000000000000000000000000000000000000000000000000000000011
1000000000000000000000000000000000000000000000000100000000000001
1000000000000000000000010001000100000000000000001010101010000001
100000000000000001111111101000100000000000000000010000000000001
1000000000000000000000000000001000000000000000000000000000S00001
1111111111111111111111111111111111111111111111111111111111111111
