C 119, 181, 254 
F 206, 206, 206 
NO ./textures/jungle/acacia_leaves_opaque.xpm
EA ./textures/jungle/jungle_leaves_opaque.xpm
WE ./textures/jungle/jungle_log.xpm    
SO ./textures/jungle/jungle_log_top.xpm

111111111111111111111111111
101010101010101010101010101
110000000000000000000000011
1010101010101S1010101010101
110000000000000000000000011
101010101010101010101010101
111111111111111111111111111
