F 203, 165, 107
C 255, 233, 181
NO ./textures/library/barrel_bottom.xpm
EA ./textures/library/birch_fence.xpm
WE ./textures/library/bookshelf.xpm
SO ./textures/library/window.xpm

111111111111111111111111111
101010101010101010101010101
101010101010101010101010101
110000000000000000000000011
1110000000000S0000000000111
110000000000000000000000011
101010101010101010101010101
101010101010101010101010101
111111111111111111111111111

