C 119, 181, 254 
F 206, 206, 206 
EA ./textures/red.xpm
NO ./textures/eagle.xpm         
SO ./textures/greystone.xpm     
WE ./textures/purplestone.xpm

1111111111111
1001000111001
100000E000001
100010000001
1111111111111
