C 255,    20 ,30       
EA ./textures/red.xpm
      F 255,6,6
     NO      ./textures/eagle.xpm         
SO ./textures/              greystone.xpm     





WE ./textures/purplestone.xpm


1111111111111111111111111111111
1111111111111110000000000001111
100000000000000000111000100011
1100001000000N00000000000011 1
1111111000000000000N000000011
111111111111111111111111111111111111
110000100000011110000000000001
1000000000001100000000000011111
110000000000111000000000101111
110000000001111000000000000111
111111111111111111111111111111111
111111111111111111111111111111111
