C 255,    20 ,30       
EA ./textures/red.xpm
      F 250, 46,6 
     NO      ./textures/eagle.xpm         
SO ./textures/              greystone.xpm     




WE ./textures/purplestone.xpm



  
    
 1111111111111111111111111111111
111111111111111000000000001111
100000000000000000111000100011
1100001000000000000000000111
1111111000000000N0000000011
111111111111111111111111111111111111
110000100000011110000000000001
1000000000001100000000000011111
110000000000111000000000101111
110000000001111000000000000111
111111111111111111111111111111111
111111111111111111111111111111111
 
11111
11111
11


