C 255,    20 ,30   
EA ./textures/red.xpm
      F  0,      214 ,  000002
     NO      ./textures/eagle.xpm     
SO ./textures/greystone.xpm







WE ./textures/purplestone.xpm






       1     11111111111111111
1111111111111110000000000001111
100000000000000000111000100001
110000100000000000000000001111
1111111000000000000000000001 
111100000000001100000000000011
1 1111111111111111111111111111111111
110000000000011110000000000001
10000000000011000N00000000011
110000000000111000000000101111
110000000001111000000000000111
111111111111111111111111110111111
                        1111
111111111
101010101
1101010001
111111111




