C 255,    20 ,30    
EA ./textures/red.xpm
      F  0,      214 ,   25
     NO      ./textures/eagle.xpm     
SO ./textures/greystone.xpm







WE ./textures/purplestone.xpm


      111111111111111111111111111111
111111111000100000000000011111
100000000000000000111000100001
110000100000000000000000001111
100001111111000000000000111111
1111111000000000W0000000000001
11110000000000110000000 0000011
1                            1
110000000000011110000000000011
100000000000111000000000000011
110000000000111000000000001111
110000000001111000000000000111
111111111111111111111111111111111
