C 255,    20 ,30       
EA ./textures/red.xpm
      F 255,6,6
     NO      ./textures/eagle.xpm     
SO ./textures/greystone.xpm






WE ./textures/purplestone.xpm
    
       1     11111111111111111
1111111111111110000000000001111
100000000000000000111000100001
110000100000000000000000001111
1111111000000000000000000001 
111111111111111111111111111111111111
110000100000011110000000000001
10000000000011000N00000000011
110000000000111000000000101111
110000000001111000000000000111
111111111111111111111111111111111
111111111111111111111111111111111
                        1111
111111111
101010101
1101010001
111111111
111111101
    1  11



