F 113, 78, 65
C 82, 82, 82 
NO ./textures/mine/cracked_wall.xpm
EA ./textures/mine/furnace_front_on.xpm         
SO ./textures/mine/basalt.xpm     
WE ./textures/mine/furnace_front_on.xpm

1111111111111111111111111111111111111111111111111111111111111111
1000000000000000000000000000000000000000000000000000000000000011
1000000000010000010110100111110001100111111111111111110000000011
10000000011 110001001010000001000110000000000000001  10000000011
10000000011 1101110110111111110001100000000000000011110000000011
100000000001000000001000000000000000000000E000000000000000000001
1111111111111111111111111111111111111111111111111111111111111111
